NO ./TEXTURES/XPM/WALLS/BRICK_3D.xpm
SO ./TEXTURES/XPM/WALLS/CONCRETE_3C.xpm
WE ./TEXTURES/XPM/WALLS/StoneUWHitlerL.xpm
EA ./TEXTURES/XPM/WALLS/BRICK_6D.xpm

C 133,6,6
F 39,41,43



111111111111111
100000100000001
101110101111101
100010100000101
111010111110101
100010000010101
101011101010101
101000101000101
101110101011101
100010000010001
101011101110101
101000101000101
111110101011111
10000N000000001
111111111111111