NO ./TEXTURES/XPM/WALLS/LAB_2B.xpm
SO ./TEXTURES/XPM/WALLS/TECH_4E.xpm
WE ./TEXTURES/XPM/WALLS/PIPES_1A.xpm
EA ./TEXTURES/XPM/WALLS/CONSOLE_1B.xpm

F 128,128,128
C 192,223,239

1111111111111111111
1000000000000000001
1001110000100000001
1001110000100000001
1000000000011110001
1000000111100000001
1000000100100000001
11100001001000N0001
1110000000000000001
1111111111111111111