NO ./TEXTURES/XPM/WALLS/BRICK_3D.xpm
SO ./TEXTURES/XPM/WALLS/CONCRETE_3C.xpm
WE ./TEXTURES/XPM/WALLS/StoneUWHitlerL.xpm
EA ./TEXTURES/XPM/WALLS/BRICK_6D.xpm

C 255,69,0
F 105,105,105



1111111111111111111111111
1S00000000000010000000001
1011111111101010111111101
1010001000101010001000101
1010101010101110101010101
1010100010100010100010101
1010111011101010111010101
1010001010001010001010101
1011101010111011101011101
1000100010000010000010001
1010111110111110111110101
1010001000000010001000101
1111101010111010101011101
1000101010100010100000001
1011101010101110111011101
1000000010000010000000101
1011111110111111111110101
1010000000100000000010001
1010111011101011101011101
1010000010001010001000001
1011111110101111101111101
1000000000000010000000001
1111111111111111111111111