EA ./TEXTURES/XPM/WALLS/CONSOLE_1B.xpm


SO ./TEXTURES/XPM/WALLS/TECH_4E.xpm

NO ./TEXTURES/XPM/WALLS/LAB_2B.xpm
WE ./TEXTURES/XPM/WALLS/PIPES_1A.xpm

C 0,0,0
F 128,128,128

1111111111111111111
1000000000000000001
1001110000100000001
1001110000100000001
1000000000111110001
1000000111100000001
1000000100100000001
11100001001000S0001
1110000000000000001
1111111111111111111