
F 128,128,128
C 102,51,0
NO ./TEXTURES/XPM/WALLS/BRICK_3D.xpm
SO ./TEXTURES/XPM/WALLS/CONCRETE_3C.xpm
WE ./TEXTURES/XPM/WALLS/StoneUWHitlerL.xpm
EA ./TEXTURES/XPM/WALLS/BRICK_6D.xpm

11111111
10010001
10100001
1100W001
11000001
11000001
10000001
11111111