NO ./TEXTURES/PNG/SandstoneskullsD.gif
SO ./TEXTURES/PNG/Stone1D.gif
WE ./TEXTURES/PNG/StoneUWHitlerL.gif
EA ./TEXTURES/PNG/SteelwallL.gif

F 128,128,128
C 102,51,0

1111111111111111111
1000000000000000001
1001110000100000001
1001110000100000001
1000000000111110001
1000E00111100000001
1000000100100000001
1110000100100000001
1110000000000000001
1111111111111111111