NO ./TEXTURES/XPM/WALLS/LAB_2B.xpm
SO
WE ./TEXTURES/XPM/WALLS/PIPES_1A.xpm
EA ./TEXTURES/XPM/WALLS/CONSOLE_1B.xpm

F 255,255,255
C 60,192,42

1111111111111111111
1000000000000000001
100111000010000S001
1001110000100000001
1000000000111110001
1000000111100000001
1000000100100000001
1110000100100000001
1110000000000000001
1111111111111111111