NO ./TEXTURES/XPM/WALLS/LAB_2B.xpm
SO ./TEXTURES/XPM/WALLS/TECH_4E.xpm
WE ./TEXTURES/XPM/WALLS/PIPES_1A.xpm
EA ./TEXTURES/XPM/WALLS/CONSOLE_1B.xpm

F
C

1111111111111111111
1000000000000000001
100111000010000S001
1001110000100000001
1000000000111110001
1000000111100000001
1000000100100000001
1110000100100000001
1110000000000000001
1111111111111111111