NO ./TEXTURES/XPM/WALLS/LAB_2B.xpm
SO ./TEXTURES/XPM/WALLS/TECH_4E.xpm
WE ./TEXTURES/XPM/WALLS/PIPES_1A.xpm
EA ./TEXTURES/XPM/WALLS/CONSOLE_1B.xpm

F ./TEXTURES/XPM/FLOOR/SLUDGE_1A.xpm
C ./TEXTURES/XPM/CEILING/CONCRETE_4A.xpm

D ./TEXTURES/XPM/DOORS/Wolf3D_door.xpm

11111111111111111111
100000000S0000000001
10000000000000000001
10000000000000000001
11111111121111111111
10011100001000000001
10000000001111100001
10000001111000000001
10000001001111000001
11110001001001000001
10000000000001000001
11110000000001111001
10011100001000000001
10011100001000000001
11111112111111111111
10000000001000000001
10000000001000000001
11100000001000000001
11121111111000000001
11100000000000000001
11100000000000000001
11111111111111111111