NO ./TEXTURES/XPM/WALLS/BACKROOMS/yellow.xpm
SO ./TEXTURES/XPM/WALLS/BACKROOMS/yellow.xpm
WE ./TEXTURES/XPM/WALLS/BACKROOMS/yellow.xpm
EA ./TEXTURES/XPM/WALLS/BACKROOMS/yellow.xpm

F ./TEXTURES/XPM/FLOOR/BACKROOMS/yellow.xpm
C ./TEXTURES/XPM/CEILING/BACKROOMS/yellow.xpm

CL ./TEXTURES/XPM/CEILING/BACKROOMS/light_yellow.xpm

WMAP
11111111111111111111
10000000000000000001
10011100001000000001
10011100001000000001
10000000000111100001
10000001111000000001
10000001001111000001
11110001001000000001
10000000000000000001
11110000000000000001
10011100001000000001
10011100001000000001
10000000001111100001
10000001111000000001
10000001001000000001
11100111001000000001
11100000000000000001
11100000000000N00001
11100000000000000001
11111111111111111111

FLOOR_MAP
11111111111111111111
10000000000000000001
10011100001000000001
10011100001000000001
10000000000111100001
10000001111000000001
10000001001111000001
11110001001000000001
10000000000000000001
11110000000000000001
10011100001000000001
10011100001000000001
10000000001111100001
10000001111000000001
10000001001000000001
11100111001000000001
11100000000000000001
11100000000000N00001
11100000000000000001
11111111111111111111

CEILING_MAP
11111111111111111111
10000000000000000001
10011100001000000001
10011100001000000001
10000000000111100001
10000001111000000001
10000001001111000001
11110001001000000001
10000000000000000001
11110000000000000001
10011100001000000001
10011100001000000001
10000000001111100001
10000001111000000001
10000001001000000001
11100111001000000001
11100000000000000001
11100000000000N00001
11100000000000000001
11111111111111111111